WWWWWWWWWWWWWWWW
W P            W
W   W WWWWWWWWWW
W   W a    b   W
W   1 WWWWWW 2 W
W   W      W   W
W   E      W   W
W   WWWWWWWWWWWW
WWWWWWWWWWWWWWWW