WWWWWWWWWWWWWWWW
W 1          2 W
W              W
W   WWWWWWWW   W
W   W P    W   W
W   a      b   W
W   W      W   W
W   W  E   W   W
WWWWWWWWWWWWWWWW