WWWWWWWWWWWWWWWW
W P  L  1  L   W
W    L     L   W
W 2  L     L a W
W    L     L   W
W b  L     L E W
W    L     L   W
W              W
WWWWWWWWWWWWWWWW