WWWWWWWWWWWWWWWW
W P            W
W   WWWWWWWW   W
W   W  1   W   W
W   W      W   W
W   W  a   W   W
W   W      W   W
W   W   E      W
WWWWWWWWWWWWWWWW