WWWWWWWWWWWWWWWW
W P  L  W  L   W
W    L  1  L   W
W HHHHH   HHHH W
W    L  a  L   W
W    L  E  L   W
W HHHHH   HHHH W
W              W
WWWWWWWWWWWWWWWW