WWWWWWWWWWWWWWWW
W P          2 W
W   WWWWWW     W
W   W    W     W
W 1 W    W     W
W   W  3 W     W
W   a    WWWWbWW     
W   W    c    EW
WWWWWWWWWWWWWWWW
