WWWWWWWWWWWWWWWW
W 1 2 P 3 4 5  W
W      B       W
W L    L     L W
W a    b     c W
W L    L     L W
W d    e     E W
WWWWWWWWWWWWWWWW