WWWWWWWWWWWWWWWW
W            P W
W   WawwWWWW   W
W 1 W  WWWWW   W
W   W  WWWWW   W
W   W  WWWWW 2 W
W   WbWWWWWW   W
W   W    E W   W
WWWWWWWWWWWWWWWW
