WWWWWWWWWWWWWWWW
W P   1      a W
W     B      W W
W            W W
W WWWWWWWWWWWW W
W 2          b W
W            E W
WWWWWWWWWWWWWWWW