WWWWWWWWWWWWWWWW
W P W W   W  W W
W   a b   c  W W
W W W W WWWW W W
W W 1 W W    W W
W W W W W WWWW W
W W W 2 W W    W
W W W   W W E  W
WWWWWWWWWWWWWWWW