WWWWWWWWWWWWWWWW
W     1   2    W
W   L     L    W
W P   a   b  B W
W   L     L    W
W     3   4    W
W     c   d  E W
WWWWWWWWWWWWWWWW
