WWWWWWWWWWWWWWWW
W P  W    W    W
W    W 1  W 2  W
W    W    W    W
W    W    W    W
W    a    b    E
W    W    W    W
W    W    W    W
WWWWWWWWWWWWWWWW