WWWWWWWWWWWWWWWW
W   P     1    W
W   WWWWWWWWWWWW
W   W        E W
W   WWaWWWWWWWWW
W 2 W          W
W   WWWWWWWW   W
W   b          W
WWWWWWWWWWWWWWWW
