WWWWWWWWWWWWWWWW
W P            W
W      B       W
W      1       W
W              W
W WWWWWWWWWWWW W
W a          E W
WWWWWWWWWWWWWWWW