WWWWWWWWWWWWWWWW
W P  1  2  3   W
W HHHHHHHHHHHH W
W a  b  c      W
W HHHHHHHHHHHH W
W            E W
W HHHHHHHHHHHH W
W              W
WWWWWWWWWWWWWWWW