WWWWWWWWWWWWWWWW
W P 1          W
W   W WWWWWWWW W
W   W          W
W   a          b
W   W WWWWWWWW W
W   W          W
W   W   2      E
WWWWWWWWWWWWWWWW