WWWWWWWWWWWWWWWW
W              W
W   WWWaWWWW   W
W   W    2 W   W
W 1 WWWbWWWW   W  
W   W      W 3 W
W   W     EW   W
W   c      W P W
WWWWWWWWWWWWWWWW
