WWWWWWWWWWWWWWWW
W P            W
W 1 WWaWWW     W
W   W2   b     W
W   WWWWWW     W
W   W    W   3 W
W   W    W     W
W   W   Ec     W
WWWWWWWWWWWWWWWW
