WWWWWWWWWWWWWWWW
W            P W
W   WaWWWWWW   W
W 1 W WWWWWW   W
W   W WWWWWW   W
W   W WWWWWW 2 W
W   WbWWWWWW   W
W   W    E W   W
WWWWWWWWWWWWWWWW
