WWWWWWWWWWWWWWWW
W 1          P W
W WWWWWWWWWWWW W
W W          W W
W a          b W
W W          W W
W WWWWWWWWWWWW W
W E            W
WWWWWWWWWWWWWWWW