WWWWWWWWWWWWWWWW
W P            W
W WWWWWWWWWWWWWW
W W          W W
W W    1     a W
W W          W W
W WWWWWWWWWWWW W
W              E
WWWWWWWWWWWWWWWW