WWWWWWWWWWWWWWWW
W P            W
W   B      B   W
W   1      2   W
W WWWWWWWWWWWW W
W a          b W
W            E W
WWWWWWWWWWWWWWWW