WWWWWWWWWWWWWWWW
W P            W
W   WWWWWWWWWaWW
W   W      W   W
W   W      W E W
W   W      WWWWW
W   W          W
W 1 W          W
WWWWWWWWWWWWWWWW
