WWWWWWWWWWWWWWWW
W P            W
W      L       W
W      L   1   W
W      L       W
W      L       W
W a          E W
WWWWWWWWWWWWWWWW