WWWWWWWWWWWWWWWW
W     1        W
W   WWWaWWWW   W
W   W   2  W P W
W   W      W   W
W   WWbWWWWW   W   
W   W  WWWWW   W
W   W    E W   W
WWWWWWWWWWWWWWWW
